Aaron (SN)||||Celest
Aaron (WTC.4)||||SOGA
Acro||||Jim
Adam||||Keaira
Adora Bull||||Battila the Bun
Air King|Air Queen
Air Queen|Air King
Al Eye||||May Eye
Alexandra|Gabriel
Allergy|Robert Ulysses Dunn
Amara||||||Ted
Andromeda (TTTF)|Perseus
Angela (AA)||||Beauregard (AA)
Angie Ina||||Jumper (JC)
Ann Chovie|Demon Strate
Ann Tenna||||Trans Mitter
Anna Molly||||Piper (WTC)
Anomy||||Melody
Antigua|Uncletigua
Arjayess|Jehial
Arlis||||Skyla
Art|Astrid (BS)
Arthur||||Morgan Le Fey
Ashley Rose||Bliss
Asse Sette|Marmie Sette
Astrid (BS)|Art
Attila the Pun||||Pundora
Auntie Nym|Uncle Nym
Azalea||||Ray (SN)
Barbie Que||||Wolfram Tungsten
Bareface Von Wryn|Fannie
Battila the Bun||||Adora Bull
Beauregard (AA)||||Angela (AA)|D. Lusion
Bec on Call|Hydrogen
Becca||||D. Cease
Becka|Brusque
Bernard||||Kelei
Besanii||||Bill Fold
Bev (LOTD)|Bryce
Bianca|Roland
Bill||||Elem N. Tery
Bill Fold||||Besanii
Bink|Chameleon||||Sabrina
Bliss|Ashley Rose
Blue Jean|Whurl Poole
Bluebell||||||Jordan
Blyght|Brawnye
Braille||||Jana
Brant (WTC)||||Sara Nade
Brawnye|Blyght
Breanna|Justin (ASFC)
Bria|Eskil
Briskil|Nina
Brusque|Becka
Bryce||Bev (LOTD)||Harmony
Can Bee||||Can D (TTTF)
Can D (TTTF)||||Can Bee
Cassaundra||||Cassaunova
Cassaunova||||Cassaundra
Cathryn|Contrary
Cedric|Celeste
Celest||||Aaron (SN)
Celeste|Cedric
Cencow||||||griffiness
Cesar|Glitter (TD)
Challenge|Chellony
Chameleon|Bink
Chandra||||Dudley Dragonman
Charity|Naro
Charming|Wenda
Charnel|Merla
Charon|Haughty
Che|Cynthia; Surprise
Cheiron|Chex
Chellony|Challenge
Chem|Xap
Cherie|Chester
Chester|Cherie
Chet||||||sea cow
Chex|Cheiron
Chlorine|Xanth
Ci-Gar||||Ci-Garette
Ci-Garette||||Ci-Gar
Claire Voyant (UIAH)|Sammy
Clio|Sherlock
Com Passion|Com Pewter
Com Pewter|Com Passion
Comealong||||Getaway
Con||||Trudy
Conan the Librarian|Tasmania Devil
Contrary|Cathryn
Crabapple||||Curtis (DDD)
Crombie|Jewel
Crony||||Vendetta
Crunch|Sleeping Beauty
Cube|Ryver
Curtis (DDD)||||Crabapple
Cylla Cybin||||Eli (IO)
Cynthia|Che; Umlaut
Cyrus (NM)|Merci
Cyrus (TTTF)||||Rhythm
D. Cease||||Becca
D. Lusion|||||Beauregard (AA)
Dara|Humfrey
Dave (SN)||||Nikki
David Baldwin||||Jaylin
Dawn|Picka Bone
Day Stallion||||Mare Imbrium
Debra||||Random Factor
Demon Strate|Ann Chovie
DeMonica|Dolin
Denim|Jean (SN)
Desiree|Hiatus
Dick Philip|Olive Hue
Dolin|DeMonica
Doll||||Red Pepper
Dolph|Electra; Taplin; Nada
Donald (ASFC)|Sally
Dor|Irene (CaR)
Dr. Moribund||||Mexine
Dragon King (FP)||||Dragon Lady (FP)
Dragon Lady (FP)||||Dragon King (FP)
Drek||||Karia
Drew (CuR)|Drusie
Drew (GWITS)||||Jody
Drusie|Drew (CuR)
Dudley Dragonman||||Chandra
Dug|Kim (DDD)
Earth|Gaia
Ease|Kandy
Ebnez|Mnem
Eck Sray||||Jade
Edsel|Pia Putz
Electra|Dolph
Elem N. Tery||||Bill
Eli (IO)||||Cylla Cybin
Eli (LOTD)||||Sela
Elsie|||||Jordan
Emerald|Merara
Eric||||Harberian Barbarian
Erin Kitty Litter|Midrange
Eris|Jumper (JC)||||||Sharon (JC)
Eskil|Bria
Eunice||||Fate
Eve|Pluto
Fairmost||||Meriel (KG)
Fannie|Bareface Von Wryn
Faro||||Zed
Fate||||Eunice
Fauna||||Nyet
Fiera (IO)||||Fiery
Fiery||||Fiera (IO)
Finn||||Pyra
Flora||||Wayne
Fornax|Nemesis
Forrest|Mare Imbrium
Fracto|Happy Bottom
Frank (BS)||||Maddy
Frosteind||||Zach (SN)
Gabriel|Alexandra
Gaia|Earth
Gary Gar|Gayle Goyle
Gattila the Gun||||Pundora
Gayle Goyle|Gary Gar
Gen Eric|Gen Erica
Gen Erica|Gen Eric
Getaway||||Comealong
Gina||||Girard
Girard||||Gina
Gizmo|Nancy
Glenna (IO)||||Hardly
Glinda|Glower
Glitter (TD)|Cesar
Glory|Hardy
Glower|Glinda
Gnonenity||||Lady Bug
Go-Go|Goody
Goar|Nydia|||||Isis
Godiva|Gouty
Goldy|Hardy
Goody|Gwendolyn|Go-Go
Gorgon|Humfrey
Gourd'n G'rd'n'r||||Petting Sue
Gouty||Godiva
Grace'l Ossein|Marrow Bones
Graeboe|Gloha
Granola|||||||Piper (WTC)
Green Horn|Sea Hag
Grey|Ivy
Grinelle||||||Crombie
Gromden|curse fiend|||||Metria
Grundy|Rapunzel
Guise||||Xina
Gusto GoesinÂ ||||Prima Donna
Guy Guyascutus||||Hadi
Gwendolyn|Goody
Hadi||||Guy Guyascutus
Hannah Barbarian|Roland (PP)
Hapless|Merge
Happy Bottom|Fracto
Harberian Barbarian||||Eric
Harbinger|||||||Maeve
Hardly||||Glenna (IO)
Hardy|Glory
Harmony||||Bryce
Harold|Helen (CaR)
Haughty|Charon
Heather (HT)|||||Shadows
Helen (CaR)|Harold
Hia||||human
Hiatus|Desiree
Hilarion|Ida
Hugo|Wira
Humfrey|Dara; Maiden Taiwan; Rose; Sofia; Gorgon; MareAnn
Hurry||||Ilura
Hydrogen|Bec on Call
Ida|Ho; Hilarion; Jaycn
Ilene (AA)|Sim
Ilura||||Hurry
Irene (CaR)|Dor
Iris|Trent
Iron Maiden (WTC)||||||unnamed human king; Rob
Iseult of the White Hand|Tristan (UIAH)
Iseult the Fair|Mark|||||Tristan (UIAH)
Isis|Osiris|||||Ted; Goar
Ivan||||Maiden Yukay
Ivy|Grey; Naldo
Ize|Robin
Jacob|Lauryl
Jade||||Eck Sray|Mac; Mike (TD); Mal
Jaff|Mari
Jana||||||Braille
Janet Hines|Richard C. White
Jaycn|Ida
Jaylin||||David Baldwin
Jean (SN)|Denim
Jehial|Arjayess
Jenny (IOV)|Jeremy
Jeremy|Jenny (IOV)
Jewel|Crombie
Jim||||Acro
Jim Baldwin|Mary Baldwin||unnamed Mundane
Joan|John (OO)
Jody||||Drew (GWITS)
John (OO)|Joan
John (TTTF.10)|Marsha
Jonathan|Millie
Jordan|Threnody||||Elsie|Bluebell
Joy'nt Bone||||Skully Knucklehead
Jumper (JC)|Eris|||||Angie Ina; Sharon; Phanta
Justin (ASFC)|Breanna
Justin Case|Miss Take
Justin Time|Miss Inform
Kandy|Ease
Karia|Drek
Keaira||||Adam
Kelei||||Bernard
Kim (DDD)|Dug
King (IOV)|Queen (IOV)
King of Lioness|White Flower
Kody||||Zosi
Lacuna|Vernon
Lady Bug||||Gnonenity
Lauryl|Jacob
Lena||||||tiger
Lotus||||Wade
Mac|||||Jade
Maddy||||Frank (BS)
Maeve|Warren Warrior||||||Harbinger
Maiden Taiwan|Humfrey
Maiden Yukay||||Ivan
Mal|||||Jade
Mare Imbrium|Forrest|||Day Stallion
MareAnn|Humfrey
Mari|Jaff
Mark|Iseult the Fair
Marmie Sette|Asse Sette
Marrow Bones|Grace'l Ossein
Marsha|John (TTTF.10)
Mary Baldwin|Jim Baldwin||unnamed Mundane
May Eye||||Al Eye
Melantha|Naldo|Merwin
Melody||||Anomy
Merara|Emerald
Merci|Cyrus (NM)
Merge|Hapless
Meriel (KG)||||Fairmost
Merla|Charnel
Merlin|Tapis
Merwin|Melantha
Merwyn|Meryl
Meryl|Merwyn
Metria|Valeno|||||Gromden
Mexine||||Dr. Moribund
Midrange|Erin Kitty Litter
Mike (TD)|||||Jade
Mikhail||||Noi
Millie|Jonathan
Miss Inform|Justin Time
Miss Take|Justin Case
Mitch|Tiara
Mnem|Ebnez
Morgan Le Fey||||Arthur
Morris|Siren
Murphy|Vadne
Nada|Vore; Dolph
Naldo|Melantha; Ivy
Nancy|Gizmo
Naro|Charity
Nathan|Nera
Nemesis|Fornax
Nephthys|Typho|||||Osiris
Nera|Nathan
Nikki||||Dave (SN)
Nimbus||||Fray
Nina|Briskil
Noi||||Mikhail
Nya||||Quin
Nydia|Goar
Nyet||||Fauna
Okra|Smithereen
Ole|Orgy
Olive Hue|Dick Philip
Orgy|Ole
Osiris|Isis|||||Nephthys
Peek|Pook
Persephone|Pluto
Perseus|Andromeda (TTTF)
Petting Sue||||Gourd'n G'rd'n'r
Phanta|Shepherd|||Jumper (JC)
Phil Istine|Tipsy
Philip (CuR)|Silhouette
Pia Putz|Edsel
Picka Bone|Dawn
Piper (WTC)||||Anna Molly|||Pundora; Granola
Pluto|Eve|Persephone|||||Sharon (JC)
Pook|Peek
Prima Donna||||Gusto Goesin
Prince (IOV)|Princess (IOV)
Princess (IOV)|Prince (IOV)
Psyche||||Timothy
Pundora||||Attila the Pun; Gattila the Gun||Piper (WTC)
Punny||||Unpun
Pyra||||Finn
Queen (IOV)|King (IOV)
Quin||||Nya
Rachel (LOTD)|Woofer
Random Factor||||Debra
Rapunzel|Grundy
Raven||||Son
Ray (SN)||||Azalea
Red Pepper||||Doll
Rhythm||||Cyrus (TTTF)
Richard C. White|Janet Hines
Richard Siler|unnamed Mundane
Rob||||||Iron Maiden (WTC)
Robert Ulysses Dunn|Allergy
Robin|Ize
Roland|Bianca
Roland (PP)|Hannah Barbarian
Roogna|Taplin
Rose|Humfrey
Rose Quartz||||Smoky Quartz
Rosetta|Stone
Rowena (FAG)|Ruben
Ruben|Rowena (FAG)
Ryver|Cube
S Trojan||||Tess Tosterone
Sabrina|||||Bink
Sally||Donald (ASFC)
Sammy|Claire Voyant (UIAH)
Sand Witch (TTTF)||||Tuff Stuff
Sara Nade||||Brant (WTC)
Scab|Svelte
Sea Hag||Green Horn
Sean Baldwin|Willow (YIW)
Sela||||Eli (LOTD)
Sesame|Souffle
Shadows||||Heather (HT)
Sharon (JC)|||||||Pluto; Eris; Jumper (JC)
Shepard|Phanta
Sherlock|Clio
Silhouette|Philip (CuR)||||Yorick
Sim|Ilene (AA)
Siren|Morris
Skully Knucklehead||||Joy'nt Bone
Skyla||||Arlis
Sleeping Beauty|Crunch
Smash|Tandy
Smithereen|Okra
Smoky Quartz||||Rose Quartz
Sofia|Humfrey
SOGA||||Aaron (WTC.4)
Son||||Raven
Souffle|Sesame
Stanley Steamer|Stella Steamer
Stella Steamer|Stanley Steamer
Stone|Rosetta
Stymie|Stymy
Stymy|Stymie
Surprise|Umlaut; Che; Picka Bone; Brusque; Jot; Epoxy
Svelte|Scab
Sylvester|Sylvia
Sylvia||Sylvester
Tacy|Tristan (HC)
Tandy|Smash
Tapis|Merlin
Taplin|Roogna; Dolph
Tara||||Tartan
Tartan||||Tara
Tasmania Devil|Conan the Librarian
Ted||||||Amara; Isis
Terian||||Tristan (HC)
Tess Tosterone||||S Trojan
Thesis|Zaven
Threnody|Yin-Yang; Jordan
Tiara|Mitch
Timothy||||Psyche
Tipsy|Phil Istine
Trans Mitter||||Ann Tenna
Trent|Iris|unnamed Mundane
Tristan (HC)|Tacy|||||Terian
Tristan (UIAH)|Iseult of the White Hand|||||Iseult the Fair
Trudy||||Con
Tuff Stuff|Sand Witch
Typho|Nephthys
Umlaut|Surprise; Cynthia; Benzine
Uncle Nym|Auntie Nym
Uncletigua|Antigua
Unpun||||Punny
Vadne|Murphy
Veleno|Metria
Vendetta||||Crony
Vernon|Lacuna
Vertex|Vortex (PP)
Volney|Wilda
Vore|Nada
Vortex (PP)|Vertex
Wade||||Lotus
Waller|Wallette
Wallette|Waller
Warren Warrior|Maeve
Wayne||||Flora
Wenda|Charming
White Flower|King of Lioness
Whurl Poole|Blue Jean
Wilda|Volney
Willow (YIW)|Sean Baldwin
Wira|Hugo
Wolfram Tungsten||||Barbie Que
Woofer|Rachel (LOTD)
Xanth|Chlorine
Xap|Chem
Xavier|Zora
Xeth|Zyzzyva
Xina||||Guise
Yin-Yang|unnamed woman|Threnody
Yorick|||||Silhouette
Zach (SN)||||Frosteind
Zaven|Thesis
Zed||||Faro
Zoltan Dread Locks||unnamed ogress
Zora|Xavier
Zosi||||Kody
Zyzzyva|Xeth