Adissec Nirp|Ida
Anomie|Anomy
Blyght|Blythe
Captain M|CPM
Cry Sis|Cri Sis
D. Sist (WTC)|A. Sist
Dana|Dara
Dastard|Anomy
Day Horse|Horseman
Dee|Chameleon
DoMinica|DeMonica
Dora|Pandora
Drivel|Sesame
Elip Sis|Ellip Sis
Fabian|Random Factor
Fanchon|Chameleon
Fat|Fate
Ghost Writer|Goar
Glow|Nimbus
Gory|Goody
Granny Ola|Granola
Haggai Hag|Ida
Heavenly Helen|Helen (CaR)
Hog|Prince (GWITS)
Hottie|Haughty
I Kandy|Kandy
Imbri|Mare Imbrium
Irrevalent Kandy|Kandy
Kay|Kaira
Litho|Lithosphere
Master Slaver|Arte Menia
Mela|Melantha
Mena|Philomena
Mentia|Metria
Mera|Merara
Mindy|Melinda
Mr. E|Zaven
Ms. Dos|MSDOS
Music Monster|Piper (WTC)
Nimby|Xanth
NoAmi|Naomi
Parody|Peeve
Peril|Sea Hag
Pete (CuR)|Com-Pete
Pewter|Com Pewter
Phlod|Dolph
Princess (HC)|Taplin
Renee|Threnody
Rhyme|Rhythm
Sb|Sin Bursar
Sea Girl|Sea Hag
Serenity|Simurgh
Silica|Robota
Sis|Thesis
Stacey Steamer|Stella Steamer
Storm King|Aeolus
Tomato|Automation
Torrent|Ryver
Trace|Metria
Trojan|Night Stallion
Woe Betide|Metria
Wynne|Chameleon
Yang|Yin-Yang
Yin|Yin-Yang
Zombie Master|Jonathan